NO textures/wall2.xpm
SO textures/wall2.xpm
WE textures/wall2.xpm
EA textures/wall2.xpm
DO textures/door.xpm
EX textures/end.xpm

F 74,73,72
C 48,47,46


        1111111111111111111111111
        1000000000110000000000001
        1011000001110000000000001
        1001000000D0001000E000001
111111111011000001110000000000001
10000000001100000111011111D111111       
11110111111111011100000010001
11110111111111011101010010001
11000000110101011100000010001
1X00000000000001100000010001
10000000000000001101010010001
1100000111010101111101111101111
11110111 1110101 101111010101
11111111 1111111 111 111111111


