NO textures/1
SO textures/2
WE textures/3
EA textures/4


F 255,73,72
C 48,55,100


11111111111111111111111111111
10000000001100000110111110111111       
11110111011110111000000100011111
    11110111111111011101010010001
11111000001101010111000000100011
100000N00000000110000001000111
10000000000000001101010010001
1100000111010101111101111101111
11110111 1110101 101111010101
11111111 1111111 111 111111111





