NO ./src/path_to_the_north_texture
SO ./src/path_to_the_north_texture
WE ./src/path_to_the_north_texture
EA ./src/path_to_the_north_texture

F 220,100,0
C 225,30,0


111111
  11111
111N01
11111



