NO textures/wall2.xpm
SO textures/wall2.xpm
WE textures/wall2.xpm
EA textures/wall2.xpm
EX textures/end.xpm
DO textures/door.xpm



F 74,73,72
C 48,47,46

       11111111111111111111111111111111
        1000000000D00000000000000000001
        10110000011100000000000000000001
        11111D11111111111111D1111111111
        10010000000000100E000000111111
111111111011000001110000000000001
100000000000000001101110110111111       
 111D111000111D1111111100011
11110111111111011101010010001
11000000110101011100000010001
1000000000000001100000010001
1000000000000000X1010100D0001
1100000111010101111101111101111
11110111 1110101 101111010101
11111111 1111111 111 111111111





