        1111111111111111111111111
        1000000000110000000000001
        1011000001110000000000001
        1001000000000000000000001
111111111011000001110000000000001
100000000011000001110111111111111
11110111111111011100000010001
  11110111111111011101010010001
11100000011010101110000001000111111111
100011111111111100000000011000000111
100011          1001101010010000001
1101101        110101011011110N0111
11110101       1110101010111101001
11111111       1111111111111111111