NO ./path_to_the_north_texture



                   

SO ./path_to_the_south_texture
WE ./path_to_the_west_texture
EA ./path_to_the_east_texture

F 220,100,0
C 225,30,0   

        111111111111111111111111  
        10000000001100000000000011111111111111
        10110000000000000000001110000000000001    
        1001000000000000000000011111111111111
111111111011000001110000000000001    
100000000011000001110111111111111    
100000000011000001110111111111111 
100000000011000001110111111111111 
100000000011000001110111111111111 
111101111111110111000000100011        
  11110111111111011101010010001      
11100000011010101110000001000111111111
100011111111111100000000011000000111  
100011          1001101010010000001  
1101101        110101011011110N0111   
11110101       1110101010111101001    
11111111       111111111111111111 